dnaoyt : dayton
cinuertdso : introduces
bda : bad
haey : yeah
tolpap : laptop
slaayr : salary
eortem : remote
otcbtuininros : contributions
essav : saves
ejcpotrro : projector
xlm : xml
nmucanautgifr : manufacturing
sic : sci
eadvlateu : evaluated
rsctti : strict
veopenrnti : prevention
iaitruums : mauritius
aiddntio : addition
rsuf : surf
otgromnip : promoting
kleiylnu : unlikely
apardte : adapter
silod : solid
vltyirlua : virtually
lbli : bill
egeicodrpn : proceeding
ilno : lion
xmae : exam
innossexte : extensions
rscegha : charges
smoep : poems
lpreti : triple
niliolms : millions
rqiynue : enquiry
aiteld : detail
attuets : statute
saechm : schema
nosretuh : southern
iretronci : criterion
oinnitdsyac : syndication
fsbreed : freebsd
tohtra : throat
osbi : bios
ctfeaf : affect
iheaisrttcrcac : characteristic
gnrolli : rolling
wimsnimg : swimming
ferues : refuse
laud : dual
ligbnkco : blocking
gepj : jpeg
ongssipt : postings
bseelc : celebs
kliend : linked
nieimzmi : minimize
nonamda : madonna
oninntotaa : annotation
acb : abc
jbso : jobs
irergnsenept : representing
iiemcdne : medicine
knce : neck
psga : gaps
hpsigun : pushing
otrac : actor
oirvtienetsnn : interventions
oatwsehm : somewhat
eedy : eyed
oyurs : yours
enlov : novel
rnodsu : rounds
edtueexirpn : expenditure
lyhdowloo : hollywood
rruyma : murray
ckde : deck
eianterlorac : recreational
lrgis : girls
ltfuayc : faculty
gsrhfeti : fighters
der : red
smkkaobro : bookmarks
piahrs : parish
rrae : rare
tmi : tim
eolj : joel
uedrmr : murder
aprlh : ralph
ser : res
nlaotieacdu : educational
harhootgpipc : photographic
aijl : jail
aidngergr : regarding
eactrli : article
tangoemlevrn : governmental
mholse : holmes
lidsanmd : midlands
sunas : susan
baelm : blame
arseiv : varies
xonpertiia : expiration
relaecd : cleared
pcoso : scoop
yuebrs : buyers
slne : lens
ecolter : electro
odmiplce : compiled
elndi : lined
rcoi : rico
oka : oak
sanhpsi : spanish
ohewotmn : hometown
ecstwroer : worcester
aireledz : realized
nncya : nancy
beab : babe
berde : breed
cseilpa : special
eocfef : coffee
satlyan : analyst
elmra : realm
sian : asin
alrteics : articles
stenpers : presents
veaneg : geneva
anloiisutm : simulation
ernwga : wagner
adeasncv : advances
mir : rim
claaus : casual
evbra : brave
prtloa : portal
dylruop : proudly
tsaialp : spatial
slpiphi : philips
iepntincos : inspection
rnegangucio : encouraging
rpdoie : period
fnasnit : infants
laiesfcsid : classified
abn : nba
odoh : hood
dsunepeds : suspended
oticeatrpnris : practitioners
seoret : stereo
eagv : gave
chaicolt : catholic
ryacz : crazy
onatnidici : indication
rnedbegi : breeding
eehalsc : chelsea
efenjinr : jennifer
owksr : works
troooprnip : proportion
asgb : bags
linsalsonttai : installations
ewdkeen : weekend
luenc : uncle
rthpeop : prophet
ssceufo : focuses
rktaupcnby : bankruptcy
clcye : cycle
alloc : local
ame : mae
eartril : trailer
msona : mason
horsedl : holders
yadnlru : laundry
neasrmu : surname
hardle : herald
acerert : terrace
haser : share
lekinb : belkin
marmgoerp : programme
sodurnur : surround
onqseuit : question
spulpeid : supplied
itocps : topics
iocsonmpteit : competitions
ipnelarbt : printable
nmtotoucapi : computation
eken : knee
sciepse : species
ohcrna : anchor
preort : report
mtenmoev : movement
sco : soc
cnrienoigto : recognition
ploos : pools
etcsesat : cassette
lba : lab
rapy : pray
fumrhal : harmful
edkiny : kidney
arereil : earlier
setgbig : biggest
iomifdde : modified
ipdraesewd : widespread
iarng : grain
fuyaliq : qualify
clucleaatd : calculated
ivcroeniiatf : verification
lai : ali
yaswla : always
ihapperrle : peripheral
enztiic : citizen
nsmoth : months
tcuiilfdf : difficult
oucth : touch
tencdocud : conducted
rdy : dry
torso : roots
acertr : carter
vidnrig : driving
icillcna : clinical
tesissncit : scientists
ssaey : essay
artahm : martha
rvdsloaa : salvador
ersuysv : surveys
emss : mess
llnee : ellen
soblindrecae : considerable
sdierct : credits
vcitmi : victim
ucsp : cups
ivaruesln : universal
ifebr : brief
tieoalvne : elevation
csenloo : console
rssco : cross
fldeowol : followed
esivcoeuntc : consecutive
bpoer : probe
elcwgaodnke : acknowledge
eninoitvn : invention
earsrmk : remarks
isereotrpp : properties
daasl : salad
rvay : vary
esvlva : valves
aotbu : about
odsot : stood
oiclcleselbt : collectibles
epsiomdr : promised
rentgad : granted
eidddec : decided
eiximzam : maximize
hoypgagre : geography
cslletoreoh : cholesterol
prcieatls : particles
fluyl : fully
eaplr : pearl
ajy : jay
edre : reed
tmhe : them
rman : mrna
rgennaiim : remaining
nenittion : intention
tonemndo : edmonton
pnstecoc : concepts
thybeer : thereby
gkee : geek
yukret : turkey
sshto : shots
itrasg : gratis
kchcngei : checking
asdrauyt : saturday
rtlc : ctrl
acltaoiltmuay : automatically
eaarngeut : guarantee
eenmy : enemy
toncglielc : collecting
ezpri : prize
tsgnisli : listings
ssr : rss
deensef : defense
cmea : came
rvdioec : divorce
sinedergnit : ingredients
gsru : rugs
eiabtrutt : attribute
alcan : canal
palpay : paypal
unnfy : funny
iercaont : creation
umtrhpi : triumph
mpdiiel : implied
nveiyraetllat : alternatively
rsluusp : surplus
oaconrt : cartoon
llsyi : silly
ggeara : garage
oordgn : gordon
uort : tour
ocdonertll : controlled
alcm : calm
edovreerc : recovered
tdataumeo : automated
laedhnd : handled
igopss : gossip
ntocerias : reactions
esormedpcs : compressed
olceaoigtclhn : technological
osnturddoe : understood
neohc : cohen
eiusprspl : suppliers
refsguee : refugees
ohgu : hugo
mofa : foam
ielevanrot : revelation
dnedanegre : endangered
otigaisobln : obligations
tgvrnaoia : navigator
sevne : seven
eruocs : source
ncecisse : sciences
deugsi : guides
myqsl : mysql
tadkinph : thinkpad
roeywdk : keyword
danai : diana
esntwe : newest
rneetega : generate
iker : erik
etchasw : watches
eaetdrt : treated
iudosts : studios
ocotaendri : coordinate
eimrsc : crimes
lazlmoi : mozilla
lvdeope : develop
rriupsisgn : surprising
por : pro
findgni : finding
aydsr : yards
cnenehad : enhanced
kmkorbao : bookmark
ckhesc : checks
yulitg : guilty
asyleiclep : especially
omrtunpcere : procurement
eaestn : senate
fseidl : fields
rwas : wars
cilfoctn : conflict
rxieesp : expires
onssare : reasons
obol : bool
whso : show
effrot : effort
bnilk : blink
lijl : jill
mcomon : common
onehy : honey
seelnwls : wellness
wdroen : wonder
githusrtpb : pittsburgh
bcuci : cubic
iedw : wide
lnogick : locking
aws : was
dsemteiat : estimated
apeetrasd : separated
bneo : bone
saenrlt : rentals
rmreieep : premiere
enatgsi : seating
girnece : generic
airltcy : clarity
uusiarcftetnrr : infrastructure
asielr : israel
anarcfi : african
eccdeus : succeed
bfetasl : belfast
hesiisefr : fisheries
ihshg : highs
ncrueigd : reducing
dretaisev : advertise
apnirgk : parking
ylpa : play
nsgu : guns
rssttee : streets
tynctaiisirh : christianity
eemitxelnpra : experimental
neon : none
inftan : infant
caektps : packets
mij : jim
dxueecld : excluded
tcsa : cast
smaeruse : measures
lertae : relate
fqa : faq
ctsku : stuck
seifevend : defensive
tliorosrenavc : controversial
fewrokcor : workforce
eldpye : deeply
wabpege : webpage
muia : maui
hfre : href
nietnxgol : lexington
gareetr : greater
tntnea : tenant
eylgrla : gallery
wraerseah : shareware
koya : okay
talraluocc : calculator
aenulr : lauren
suirsna : russian
nsail : nails
mawbsce : webcams
nocfugsi : focusing
uhsp : push
uaht : utah
omsrdoeb : bedrooms
cedirvenpo : providence
ezutili : utilize
cteax : exact
eileuvnj : juvenile
skmchltoo : stockholm
eyttb : betty
btscacakrk : trackbacks
ropidcie : periodic
efnsdceefri : differences
oopritn : portion
eottlbs : bottles
oslot : tools
cirspuet : pictures
drseana : andreas
esayprw : spyware
eemhtl : helmet
derafle : federal
eesdf : feeds
toofarrewp : waterproof
amriwref : firmware
oefrtawo : footwear
raibld : bridal
tonek : token
imnnoonati : nomination
ragsbnia : bargains
lexce : excel
eflrrrae : referral
dthpe : depth
arynaju : january
ebrfso : forbes
avlert : travel
oerss : roses
aspn : span
suftf : stuff
okgnobi : booking
tiouserabi : obituaries
rlaywse : lawyers
cklu : luck
aetsrr : arrest
yvan : navy
glnyegaoe : genealogy
olsok : looks
giraoge : georgia
krte : trek
udgasrhet : daughters
tliiaa : italia
amecbrh : chamber
hvi : hiv
aaergnr : arrange
ytcrsehaci : citysearch
ekdmar : marked
tpxroniloae : exploration
iosaprtorpnpia : appropriations
ndoe : done
itcwe : twice
tahngtoimn : nottingham
sfeftec : effects
lleapnosyr : personally
cnerrtcioos : corrections
qcuhnitees : techniques
truhksi : turkish
uicers : cruise
odnosc : condos
uasgr : sugar
otnd : dont
rhee : here
rvedyeoyb : everybody
yoisglcoo : sociology
ceniciistf : scientific
trtnuigaaslnoco : congratulations
inlk : link
sealc : scale
irgnid : riding
eesrlwehe : elsewhere
acl : cal
raaml : alarm
ontiats : station
iaofnimtlaron : informational
spihltoa : hospital
ldt : ltd
ddas : adds
stcso : costs
tcso : cost
rcubrheso : brochures
vedaan : nevada
nynlo : nylon
srogpu : groups
aootrlceni : relocation
naodmcm : command
snloet : stolen
agnmrik : marking
vnialc : calvin
suincmostl : columnists
vudlae : valued
cpooer : cooper
tsseenv : stevens
----------------------------------------------------------------------
Result ? True
----------------------------------------------------------------------
{FLG:70c42b6d6818f3141865f10d1608f7a9763138554f6d5120662222189854231c}
----------------------------------------------------------------------
